
Ключ: лимон

Таблица моноалфавитного соответствия: 
х - а
у - б
м - в
г - г
ш - д
д - е
с - ж
я - з
н - и
в - й
ь - к
ж - л
ы - м
а - н
з - о
ю - п
к - р
и - с
й - т
б - у
т - ф
э - х
ч - ц
р - ч
е - ш
щ - щ
ц - ъ
л - ы
ф - ь
о - э
п - ю
ъ - я
